3.=.5.#.l.t.L..S
8.\.4.x.H.P.I...
.E.@.[.c.-.Y.M..
.3.=.5.#.l.t.L..
0.8.\.4.x.H.P.I.
2.E.@.[.c.-.Y.M.
.1.3.=.5.#.l.t.L
X..8.\.4.x.H.P.I
