S#........######
.#..0...0......#
............#..#
.1..1.......#..#
...11...........
........2.......
...###.........#
........2..3..3X
