................
1212121212121212
#.#.#.#.#.#.#.#.
X.1.1.1.1.1S1.#.
#.#.#.#.#.#.#.#.
#.#.#.#.#.#.#.#.
1212121212121212
................
