S!........!!!!!!
.!..0...0......!
............!..!
.4..4.......!..!
...44...........
........2.......
...!!!.........!
........2..3..3X
