.#1..#1..##...#S
.64..53..21...1.
.11..#1..##...#.
.11..#1..##...#.
.11..#1..##...#.
6#1..#1..##...#.
.75..42..31...#.
X.1..#1..##...#.
