X.!...0..!..0.0S
000.!.!...0.!.!!
..!!.0000!.!..0.
.0!!.!...0..!.!!
...!..0.!..!..0.
00000!.!!0!.00!!
0.!...0....0..!.
..0...!.!.!...0.
