3.=.5..........S
8.\.4...........
.E.^.[..........
.3.=.5..........
0.8.\.4.........
2.E.^.[.........
.1.3.=.5........
X..8.\.4........
