................
0202020202020202
!.!.!.!.!.!.!.!.
X.0.0.0.0.0S0.!.
!.!.!.!.!.!.!.!.
!.!.!.!.!.!.!.!.
0202020202020202
................
