X..2.2.22.22.2.S
!.0.!!2!!2!!2.!.
!!.0.!!!!!!!.0.!
!!!.0.!!!!!.0.!!
!!!!.0.!!!.0.!!!
!!!!!.0.!.0.!!!!
!!!!!!.0.0.!!!!!
!!!!!!!.0.!!!!!!
