S..###...121..##
...#.#...2.2..##
...###...121..##
121...121..121..
2.2...2.2..2.2..
121...121..121..
...121..###...##
...2.2..#.#...2X
