.!0..!0..!!...!S
.64..53..20...0.
.00..!0..!!...!.
.00..!0..!!...!.
.00..!0..!!...!.
6!0..!0..!!...!.
.75..42..30...!.
X.0..!0..!!...!.
