S..###...ABA..##
...###...B.B..##
...###...ABA..##
ABA...ABA..ABA..
B.B...B.B..B.B..
ABA...ABA..ABA..
...ABA..###...##
...B.B..#.#...B0
