S..!!!...020..!!
...!.!...2.2..!!
...!!!...020..!!
020...020..020..
2.2...2.2..2.2..
020...020..020..
...020..!!!...!!
...2.2..!.!...2X
