X..1.1.11.11.1.S
#.0.##1##1##1.#.
##.0.#######.0.#
###.0.#####.0.##
####.0.###.0.###
#####.0.#.0.####
######.0.0.#####
#######.0.######
