S#........######
.#..A...A......#
............#..#
.D..D.......#..#
...DD...........
........C.......
...###.........#
........C..B..B0
