
||||||||||||||||||||||||||||||||||||||||||||||||||||||||||||||||||||||||||||||||
||||||||||||||||||||||||||||||||||||||||||||||||||||||||||||||||||||||||||||||||
||                    ||                                ||                    ||
||                    ||                                                      ||
||                    ||                                ||                    ||
||                    ||                                ||                    ||
||                    ||                                ||                    ||
||                    ||                                ||                    ||
||                    ||                                ||                    ||
||                    ||                                ||                    ||
||                    ||                                ||                    ||
||                    ||                                ||                    ||
||                    ||                                ||                    ||
||                    ||                                ||                    ||
||                    ||                                ||                    ||
||                    ||                                ||                    ||
||                    ||                                ||                    ||
||                    ||                                ||                    ||
||                    ||                                ||                    ||
||                                                      ||                    ||
||                    ||                                ||                    ||
||||||||||||||||||||||||||||||||||||||||||||||||||||||||||||||||||||||||||||||||
||||||||||||||||||||||||||||||||||||||||||||||||||||||||||||||||||||||||||||||||
