
||||||||||||||||||||||||||||||||||||||||||||||||||||||||||||||||||||||||||||||||
||                                                                            ||
||                                                                            ||
||                                                                            ||
||                                                                            ||
||                                                                            ||
||                                                                            ||
||                  ||||||||||||||||||||||||||||||||||||||||||||||||||||||||||||
||                                                                            ||
||                                                                            ||
||                                                                            ||
||                                                                            ||
||                                                                            ||
||                                                                            ||
||                                                                            ||
||||||||||||||||||||||||||||||||||||||||||||||||||||||||||||                  ||
||                                                                            ||
||                                                                            ||
||                                                                            ||
||                                                                            ||
||                                                                            ||
||                                                                            ||
||||||||||||||||||||||||||||||||||||||||||||||||||||||||||||||||||||||||||||||||
