
||||||||||||||||||||||||||||||||||||||||||||||||||||||||||||||||||||||||||||||||
||                                                                            ||
||                                                                            ||
||                                                                            ||
||                                                                            ||
||                                                                            ||
||                                                                            ||
||                                                                            ||
||                                                                            ||
||                                                                            ||
||                                                                            ||
||            ||||||||||||||||||||||||||||||||||||||||||||||||||||            ||
||                                                                            ||
||                                                                            ||
||                                                                            ||
||                                                                            ||
||                                                                            ||
||                                                                            ||
||                                                                            ||
||                                                                            ||
||                                                                            ||
||                                                                            ||
||||||||||||||||||||||||||||||||||||||||||||||||||||||||||||||||||||||||||||||||
