
||||||||||||||||||||||||||||||||||||||||||||||||||||||||||||||||||||||||||||||||
||                    ||                                ||                    ||
||                    ||                                ||                    ||
||                    ||                                ||                    ||
||                    ||                                ||                    ||
||                    ||                                ||                    ||
||                    ||                                ||                    ||
||                    ||                                ||                    ||
||                    ||                                ||                    ||
||                    ||                                ||                    ||
||                    ||                                ||                    ||
||                                                                            ||
||                    ||                                ||                    ||
||                    ||                                ||                    ||
||                    ||                                ||                    ||
||                    ||                                ||                    ||
||                    ||                                ||                    ||
||                    ||                                ||                    ||
||                    ||                                ||                    ||
||                    ||                                ||                    ||
||                    ||                                ||                    ||
||                    ||                                ||                    ||
||||||||||||||||||||||||||||||||||||||||||||||||||||||||||||||||||||||||||||||||
