...............
.###.###.###.##
##.#.#.###.#.#.
.......#.......
.#####.#.#####.
.......#.......
##.#.#.#.#.#.##
.......#.......
.#############.
.......#.......
