...#...........
.#.#.#.#.#.#.##
.#.#.#.#.#.#.#.
.#...#.#...#...
.#######.###.##
...#...#.......
.#.#.#.###.###.
.#.#.#.#...#...
.#.#.#.#.#.#.#.
.#...#.#.....#.
